#   #     #        #    ###  ###############
    #     #                                #
#####     ###################   ############
                    
#####     ##################################
    #     #        # 
    #     #        # 
    #     #        # 
    #              #  
#   #     #        #
#   #     ##########
#   #     #
#   #     #
#   ### ###
