#   #     #        #
    #     #         
#####     ##########
                    
#####     ##########
    #     #         
    #     #         
    #     #         
                    
#                  #
