#   #     #        #
    #     #         
#####     ##########
                    
#####     ##########
    #X    #         
    #     #         
    #     #         
                    
#                  #
